#Example: Large parts of Africa and south east Asia
tropical = {
	# Южный берег СмешКонтинента
	32 33 34 35 95 222
	
}

arid = {
	# Серединные земли
	490 518 519 520 521 522 523 524 525 526 527 529 530 531 532 533 534 535 536 537
	539 540 542 543 544 545 
}

arctic = {
	# Кебабий
	2 3 4 5 6 7 9 10 11 12 13 14 15 16 18 19 20
	1195 1196 1197 1198 1199 1200 1201 1767 1224
	1768 1769 1770 1771 1772 1773 1774 1775 1776 1777 1778 1779 1780 1781 1783 1784 1785 1787 1788 1789 1790 1791 1792 1793 1794 1795 1796 1797
	1798 1799 1800 1801 1802 1803 1805 1806 1807 1808 1809 1810 1811 1812 1813 1814 1815 1816 1817 1818 1819  1820 1821 1822 1823 1824
	1825 1826 1765 1827 1828
	
	# Пригодные для жизни участки ледяных пустошей
	497 498 509 510 511 708 835
	
	# Лэминдлэнд
	832 833
	
	# Новый Табеслар
	505 506 507 508
	
}

#Example: Most of Europe north of med.
mild_winter = {
	# Юг Эресии и Англо-Смешии
	21 22 23 25 31 36 37 44 94 96 220 221 223 224 225 236 237 
	
	43 886 98 102 873 42 28 1744 885 24 101 104 872 108 99 109 891 110 874 111 330 41 128 129 112 122 124 107 876 877 126
	
	# Часть Элларии
	372 373 374 377 913 297 375 763 931 926 956 957 958 959 960
	354 355 365 366 932 368 369
	298 914 915 924 581
	
	1760
	
	# Остров Малышей
	193 192 197 196 202 203 216 215 214 218 213 217
	
	# Бандитское море
	864
	
	1051 # Медвежий остров
	
	851
	
	# Звёздный
	59 65 74 73
	
	# Утения
	313 319 320
	
	# Кочегора
	389 388 390 386 563
	
	# Чаепит, Рантайзия и другие
	295 341 515 599 601 598 623 619 565 401
	
	# Побережье Цветного моря
	420 421 422 465 1247 472 385 445 1109 572 883 477 451 452
}

#Example: Inland Europe & Scandinavia
normal_winter = {
	# Волкодав
	264
	257 258 269 261 262 259 260 266 263 265
	
	# Север Элларии и Туриания
	895 896 897 898 899 900 901 902 904 905 906 907 974
	483 485 463 484 486 487 488 482 491 982 980 981
	370 371 376 364 765 767 764 908 909 978 966 973 975 976 977
	927 928 930 921 933 929 946 947 948 912 919 920 934 936 937
	969 970 938
	923
	1844 1834 1832 1831 1849 1835 
	
	# Остров Малышей
	194 198 205
	
	# Бандитское море
	862
	
	850 # Интерион
	
	# Звёздный
	61 63 80 77 76 75 668 60
	
	# Сульдан
	254 275 276 277 278 281 282 279 280 284 285 283 286 290 288 289 291 241 242 243 274 240 256 299 238 239 
}

#Example: Russia & Lappland
severe_winter = {
	# Южнее Ледяных пустошей
	942 943
	502 503 550 580 762 766 769 939
	
	# Север Волкодава и Шетланды
	267 268 270 271 272 273
	91 92 378
	
	903
	
	# Кебабий
	1 2 3 4 5 6 7 9 10 11 12 13 14 15 16 18 19 20
	1195 1196 1197 1198 1199 1200 1201 1767 1224
	1768 1769 1770 1771 1772 1773 1774 1775 1776 1777 1778 1779 1780 1781 1783 1784 1785 1787 1788 1789 1790 1791 1792 1793 1794 1795 1796 1797
	1798 1799 1800 1801 1802 1803 1805 1806 1807 1808 1809 1810 1811 1812 1813 1814 1815 1816 1817 1818 1819  1820 1821 1822 1823 1824
	1825 1826 1765 1827 1828 8 17 1804
	
	# Пустоши севера
	504 501 492 494 499 500 497 495 498 496 950 951 949 510 509 1843 1845 1855 1854 
	
	# Новый Табеслар
	505 506 507 508
	
	# Звёздный
	78 82 62 64 79 81
}

impassable = {
	504 505 501 492 494 499 500	# Северные пустоши
	#528 538 541 546 547 548 549					# СИевские пустоши
	608 									# Пустошь Бакенроу
	564									# Пустоши на Косом
	1 8 17 1199 1804								# Пустоши Кебабьего
	758	784 825 1873 1874				# Пустоши Лэминдлэнда
	674 # Временная Тайфалия-пустошь
	865
	
	911 1119
}
