europe = {
	# Anglo-Smeshia
	21 22 23 24 25 27 28 29 30 31 42 43 885 886
	# Sinius & Altras
	105 106 107 108 109 110 111 877 97 100 103 101 98 104 99 874 112 113 871 102 872 875 114 122 128
	127 129 120 121 873 117 119 870
	331 332 340 342 343 344 345 346 339 341
	125
	# Levonia
	36 37 95 44 94 96
	
	33 34 35 38 39 40 41 
	115 116 118 123 124 130
	220 221 222 223 224 225 226 227 228 229 230 231 232 233 234 235 236 237 238 239 240 241 242 243 244 245 246 247 248 249 250 251 252 253 254 255 256
	274 275 276 277 278 279 280 281 282 283 284 285 286 287 288 289 290 291 292 299
	574 575 576 577 578 579 580 581 582 583 584
	
	892 893 894 895 896 897 898 899 900 901 902 903 904 905 906 907 908 909 910 911 912 913 914 915 916 917 918 919 920 921 922 923 924 925 926 927 928
	929 930 931 932 933 934 935 936 937 938 939 940 941 942 943
	946 947 948 949 950 951 952 953 954 955 956 957 958 959 960 961 962 963 964 965 966 967 968 969 970 971 972 973 974 975 976 977 978 979 980 981
	996 997 998 999 1000 1001 1002 1007 1008 1009 1010 1011 1012 1013 1014 1015 1016 1017 1018 1019 1020 1021 1023 1024 1025 1026 1027 1028
	1029 1030 1031 1032 1033 1034 1035 1036 1037 1038 1039 1040 1041 1042 1043 1044 1045 1046 1047 1048 1049 1050 1052 1053 1054 1055 1056 1057 1058 1059
	1060 1061 1062 1063 1064 1065 1066 1067 1068 1069 1070 1071 1072 1073 1074 1075 1076 1077 1078 1079 1080 1081 1082 1083 1084 1085 1086 1087 1088 1089 1090
	1091 1092 1093 1094 1095 1096 1097 1098 1099 1100 1101 1102 1103 1104 1105 1106 1107 1108 1114 1115 1116 1117 1118 1119 1120 1121 1122 1123 1124 1125 1126
	1127 1128 1129 1130 1131 1132 1133 1134 1135 1136 1137 1138 1139 1140
	
	297 298 352 353 354 355 356 357 358 359 360 361 362 363 364 365 366 367 368 369 370 371 372 373 374 375 376 377
	
	322 323 324 325 326 327 328 329 330
	
	492 493 494 495 496 497 498 499 500 501 502 503 504 505 506 507 508 509 510 511 512
	
	550 551 552 553 554
	
	637 638 639 640 641 642 643 644 645 646 647 648 649
	
	669 670 671 672 673 674 675 676 677 678 679 680 681 682 683 684 685 686 687 688 689 690 691 692 693 694 695 696 697 698 699 700 701 702 703 704 705
	706 707 708 709 710 711 712 713 714 715 716 717 718 719 720 721 722 723 724 725 726 727 728 729 730 731 732 733
	734 735 736 737 738 739 740 741 742 743 744
	
	835 836 837 838 839 840 841 842 849
	
	876 878 879 880
	
	887 888 889 891
	32 767
	126
	
	1226 1227 1228 1229 1230 1231
	# Gurvalia
	1202 1203 1204 1205 1206 1207 1208 1209 1210 1211 1212 1213 1214 1215 1216 1217 1218 1219 1220 1221 1222 1223
	
	1742 1318
	
	1743 1744 1745
	1746 1747 1748 1749 1750 1751 1752 1753 1754 1755 1756 1757 1758 1759
	
	1766
	
	# SmeshEuropa new
	1831 1832 1833 1834 1835 1836 1837 1838 1839 1840 1841 1842 1843 1844 1845 1846 1847 1848 1849 1850 1851 1852 1853 1854 1855
	
	1923 1930 1956 1957
}

south_main = {
	890
	293 294 295 296
	379 380
	383 411 412 413 414
	386 387 388 389 390 391 392 393 394 395 396 397 398 399 400 401 402 403 404 405 406 407
	408 409 410
	# Smeshiks
	333 334 335 336 337 338 347 381 382
	513 514 515 516
	563 564 565 566 567 568
	585 586 587 588 589 590 591 592 593 594 595 598 599 600 601 602 603 604 605 606 607 608 609 610 611 612 613 614 615 616 617 618 619 620 621 622 623 624 625 626 627 628 629 630 631 632 633 634 635 636
	843 844 845 846 847 848
	881
	944 945
	983 984 985 986 987 988 989 990 991 992 993 994 995
	1003 1004 1005 1006
	1152 1166 1167
	821 822 823 824
}

roles_continent = {
	384 385 415 416 417 418 419 420 421 422 423 424 425 426 427 428 429 430 431 432 433 434 436
	# Middle
	348 349 350 351
	437 438 439 440 441 442 443 444 445 446 447 448 449 450 451 452 453 454 455 456 457 458 459 460 461 462 463 464 465 466 467 468 469 470 471 472 473 474 475 476 477 478 479 480 481 482 483 484 485 486 487 488 489 490 491
	517 518 519 520 521 522 523 524 525 526 527 528 529 530 531 532 533 534 535 536 537 538 539 540 541 542 543 544 545 546 547 548 549
	571 572 573 659 793 794
	883
	982
	1109 1110 1111 1112 1113
	1146 1147 1148 1149 1150 1151
	1022 596 597
	# Ausger
	435 652 656 654 658 650 651 653 882 655 657
	1246 1247 1248 1249
}

kebabian = {
	1 2 3 4 5 6 7 8 9 10 11 12 13 14 15 16 17 18 19 20
	91 92 378
	1195 1196 1197 1198 1199 1200 1201 1767 1224
	1768 1769 1770 1771 1772 1773 1774 1775 1776 1777 1778 1779 1780 1781 1782 1783 1784 1785 1786 1787 1788 1789 1790 1791 1792 1793 1794 1795 1796 1797 1798 1799 1800 1801 1802 1803 1804 1805 1806 1807 1808 1809 1810 1811 1812 1813 1814 1815 1816 1817 1818 1819  1820 1821 1822 1823 1824
	1825 1826 1765 1827 1828
}

east_islands = {
	47 48 49 50 51 52 53 54 55 56 57 58 59 60 61 62 63 64 65 66 67 68 69 70 71 72 73 74
	75 76 77 78 79 80 81 82 83 84 85 86 87 88 89 90
	257 258 259 260 261 262 263 264 265 266 267 268 269 270 271 272 273
	660
	661 662 663 664 665 666 667 668
	1760 1830
}

kronos = {
	26 45 46 131 132 133 134 135 136 137 138 139 140 141 142 143 144 145 146 147 148 149 150
	151 152 153 154 155 156 157 158 159 160 161 162 163 164 165 166 167 168 169 170 171 172
	173 174 175 176 177 178 179 180 181 182 183 184 185 186 187 188 189 191
	93
	884
}

malishian_island = {
	190 192 193 194 195 196 197 198 199 200 201 202 203 204 205 206 207 208 209 210 211
	212 213 214 215 216 217 218 219
}

south_islands = {
	308 309 310 311 312 313 314 315 316 317 318 319 320 321
	555 556 557 558 559 560 561 562
	1153 1154 1155 1158 1159 1156 1157 1163 1164 1160 1161 1162 1165
	854 855 856 857 858 859 860 861 862 863 864 865 866 867 868 869
	1051
	1141 1142 1143 1144 1145
	1243 1244 1245
	1965 1966 1967 1968 1969 1970 1971 1972 1973 1974 1981 1983
}

lemindland = {
	300 301 302 303 304 305 306 307
	745 746 747 748 749 750 751 752 753 754 755 756 757 758 759 760 761 762 763 764 765 766 768 769 770 771 772 773 774 775 776 777 778 779 780 781 782 783 784 785 786 787 788 789 790 791 792
	795 796 797 798 799 800 801 802 803 804 805 806 807 808 809 810 811 812 813 814 815 816 817 818 819 820 825 826 827 828 829 830 831 832 833 834
	1761 1762 1763 1306 1764
	1856 1857 1858 1859 1860 1861 1862 1863 1864 1865 1866 1867 1868 1869 1870 1871 1872 1873 1874 1875 1876 1877 1878 1879 1880 1881 1882 1885 1931 1933 1934 1935 1936 1937 1938 1939 1940 1941
	1942 1943 1944 1945 1946 1947 1948 1949 1950 1951 1952 1953 1954 1955 1901
}

kongorlotez = {
	569 570 853
	1168 1169 1170 1171 1172 1173 1174 1175 1176 1177 1178 1179 1180 1181 1182 1183 1184 1185 1186 1187 1188 1189 1190 1191 1192 1193 1194
	1238 1236 1237 1239 1225 1240 1241 1242
}

posoh_continent = {
	850 851 852
	1232 1233 1234 1235
}

#ostatki = {
#}

# Used for RNW
new_world = {
}